{"map" : {
  "version" : "1.0",
  "width" : 32,
  "height" : 20,
  "layers" : [
    {
      "tilesetName" : "tilemap1",
      "data" : [
        14,14,14,14,14,14,14,14,45,14,14,14,14,14,14,14,14,14,14,14,14,14,14,14,14,14,14,14,14,14,14,14,
        14,48,48,48,48,48,48,48,48,48,48,48,48,48,48,48,48,48,48,48,48,48,48,48,48,48,48,48,48,48,48,14,
        14,48,48,48,48,48,48,48,48,48,48,48,48,48,48,48,48,48,48,48,48,48,48,48,48,48,48,48,48,48,48,14,
        14,48,48,48,48,48,48,48,48,48,48,48,48,48,48,48,48,48,48,48,48,42,48,48,48,48,48,48,48,48,48,14,
        14,48,48,48,48,48,48,42,48,48,48,48,48,48,48,48,48,48,48,48,48,48,48,48,48,48,48,48,48,48,48,14,
        14,48,48,48,48,48,48,48,48,48,48,48,48,48,48,48,48,48,48,48,48,48,48,48,48,48,48,48,48,48,48,14,
        14,48,48,48,48,48,48,48,48,48,48,48,48,48,48,48,48,48,48,48,48,48,48,48,48,48,48,48,48,48,48,14,
        14,48,48,48,48,48,48,48,48,48,48,48,48,48,48,48,48,48,48,42,48,48,48,48,48,48,48,48,48,48,48,14,
        14,48,48,48,48,48,48,48,48,48,48,48,48,42,48,48,48,48,48,48,48,48,48,48,48,48,48,48,48,48,48,14,
        14,48,48,48,48,48,48,48,48,48,48,48,48,48,48,48,48,48,48,48,48,48,48,48,48,48,48,48,48,48,48,14,
        14,48,48,48,48,48,48,48,48,48,48,48,48,48,48,48,48,48,48,48,48,48,48,48,48,48,48,48,48,48,48,14,
        14,48,48,48,48,48,42,48,48,48,48,48,48,48,48,48,48,48,48,48,48,48,48,48,48,48,48,48,48,48,48,14,
        14,48,48,48,48,48,48,48,48,48,48,48,48,48,48,48,48,48,48,48,48,48,48,48,48,48,48,48,48,48,48,14,
        14,48,48,48,48,48,48,48,48,48,48,48,48,48,48,48,48,48,48,48,48,48,48,48,48,48,48,48,48,48,48,14,
        14,48,48,48,48,48,48,48,48,48,48,48,48,48,48,48,48,48,48,48,48,48,48,48,48,48,48,48,48,48,48,14,
        14,48,48,48,48,48,48,48,48,48,48,48,48,48,48,48,48,48,48,48,48,42,48,48,48,48,48,48,48,48,48,14,
        14,48,48,48,48,48,48,48,48,48,48,48,48,48,48,48,48,48,48,48,48,48,48,48,48,42,48,48,48,48,48,14,
        14,48,48,48,42,48,48,48,48,48,48,48,48,48,48,48,48,48,48,48,48,48,48,48,48,48,48,48,48,48,48,14,
        14,48,48,48,48,48,48,48,48,48,48,48,48,48,48,48,48,48,48,48,48,48,48,48,48,48,48,48,48,48,48,14,
        14,14,14,14,14,14,14,14,14,14,14,14,14,14,14,14,14,14,45,14,14,14,14,14,14,14,14,14,14,14,14,14
      ]
    }]
}}
